{
    "22": 1,
    "86": 2,
    "15": 3,
    "69": 4,
    "27": 5,
    "25": 6,
    "26": 7,
    "74": 8,
    "23": 9,
    "28": 10,
    "29": 11,
    "32": 12,
    "55": 13,
    "24": 14,
    "77": 15,
    "79": 16,
    "68": 17,
    "73": 18,
    "71": 19,
    "31": 20,
    "58": 21,
    "72": 22,
    "62": 23,
    "30": 24,
    "42": 25,
    "70": 26,
    "83": 27,
    "61": 28,
    "54": 29,
    "76": 30,
    "59": 31,
    "85": 32
}