{
    "78": 1,
    "91": 2,
    "137": 3,
    "174": 4,
    "250": 5,
    "426": 6,
    "602": 7,
    "853": 8,
    "1399": 9,
    "1405": 10,
    "1410": 11,
    "1435": 12,
    "1445": 13,
    "1456": 14,
    "1462": 15,
    "1921": 16,
    "2047": 17,
    "2115": 18,
    "2143": 19,
    "2153": 20,
    "2186": 21,
    "2250": 22,
    "2330": 23,
    "2346": 24,
    "2464": 25,
    "2512": 26,
    "2582": 27,
    "2646": 28,
    "2694": 29,
    "2760": 30,
    "3134": 31,
    "3136": 32,
    "3144": 33,
    "3147": 34,
    "3152": 35,
    "3197": 36,
    "3198": 37,
    "3244": 38,
    "3250": 39,
    "3263": 40,
    "3339": 41,
    "3604": 42,
    "3648": 43,
    "3652": 44,
    "3761": 45,
    "3767": 46,
    "3798": 47,
    "3805": 48,
    "3807": 49,
    "3815": 50,
    "3835": 51,
    "3837": 52,
    "3844": 53,
    "3847": 54,
    "3860": 55,
    "3863": 56,
    "3889": 57,
    "3895": 58,
    "3909": 59,
    "3943": 60,
    "3953": 61,
    "3962": 62,
    "3973": 63,
    "4036": 64,
    "4039": 65,
    "4053": 66,
    "4069": 67,
    "4090": 68,
    "4213": 69,
    "4216": 70,
    "4219": 71,
    "4283": 72,
    "4288": 73,
    "4304": 74,
    "4501": 75,
    "4554": 76,
    "4557": 77,
    "4559": 78,
    "4563": 79,
    "4579": 80,
    "4585": 81,
    "4589": 82,
    "4604": 83,
    "4646": 84,
    "4666": 85,
    "4670": 86,
    "4677": 87,
    "4702": 88,
    "4736": 89,
    "4742": 90,
    "4769": 91,
    "4781": 92,
    "4793": 93,
    "4801": 94,
    "4809": 95,
    "4837": 96,
    "4858": 97,
    "4932": 98,
    "4941": 99,
    "4945": 100,
    "4951": 101,
    "5011": 102,
    "5054": 103,
    "5057": 104,
    "5109": 105,
    "5281": 106,
    "5301": 107,
    "5307": 108,
    "5328": 109,
    "5331": 110,
    "5355": 111,
    "5384": 112,
    "5397": 113,
    "5516": 114,
    "5523": 115,
    "5532": 116,
    "5547": 117,
    "5555": 118,
    "5557": 119,
    "5618": 120,
    "6492": 121,
    "6576": 122,
    "6596": 123,
    "6811": 124,
    "6817": 125,
    "6824": 126,
    "7245": 127,
    "7258": 128,
    "8258": 129,
    "8263": 130,
    "8414": 131,
    "8426": 132,
    "8436": 133,
    "8555": 134,
    "8613": 135,
    "8688": 136,
    "9792": 137
}